0,0,0,0,0,0,0,0,1,0,0,0,0,0,0,1,2,0,1,2
0,0,0,0,0,0,0,0,1,0,0,0,0,0,0,1,3,0,1,0
0,0,0,0,0,0,0,0,1,0,0,0,0,0,0,1,2,0,1,1
0,0,0,0,0,0,0,0,1,0,0,0,0,0,0,1,2,0,1,0
0,0,0,0,1,0,6,0,1,0,0,0,0,0,1,1,0,0,0,13
0,0,0,0,1,0,7,0,1,0,0,0,0,0,0,0,6,0,0,15
0,0,0,0,1,0,11,1,1,0,1,0,0,7,0,1,0,0,1,0
1,0,12,0,0,0,0,1,1,0,1,0,1,0,0,1,3,0,1,2
1,0,8,0,1,0,10,0,1,0,0,0,0,0,0,1,1,0,1,0
0,0,0,0,1,0,9,0,1,0,0,0,0,0,0,0,8,1,1,0
0,0,0,0,1,0,6,1,1,0,0,10,1,0,0,0,9,0,0,6
1,0,6,0,1,0,9,1,1,1,0,10,0,6,1,1,0,0,0,13
1,0,8,0,1,0,7,1,1,1,0,11,0,7,0,0,6,0,0,8
1,0,6,0,1,0,9,0,1,0,0,0,0,0,0,0,9,0,0,15
0,0,0,0,1,0,6,0,1,0,0,0,0,0,0,0,6,0,0,6
0,0,0,0,0,0,0,1,1,1,1,0,0,7,0,0,8,0,0,8
0,0,0,0,0,0,0,1,1,0,1,0,1,0,2,1,0,2,1,0
0,0,0,0,0,0,0,1,1,0,2,0,0,6,0,0,12,1,1,0
1,1,2,0,0,0,0,0,1,0,0,0,0,0,1,1,0,0,0,4
0,0,0,0,0,0,0,1,0,1,0,9,1,0,0,0,0,0,0,0
1,1,0,0,1,0,6,0,0,0,0,0,0,0,0,0,0,0,0,0
0,0,0,0,0,0,0,1,0,1,1,0,0,6,0,0,0,0,0,0
1,1,1,0,1,1,3,0,0,0,0,0,0,0,0,0,0,0,0,0
0,0,0,0,0,0,0,0,1,0,0,0,0,0,0,0,2,0,0,4
0,0,0,0,0,0,0,0,1,0,0,0,0,0,0,0,2,0,0,13
0,0,0,0,0,0,0,0,1,0,0,0,0,0,0,0,0,0,0,4
0,0,0,0,0,0,0,0,1,0,0,0,0,0,0,0,3,0,0,2
0,0,0,0,0,0,0,0,1,0,0,0,0,0,0,0,2,0,0,5
0,0,0,0,0,0,0,0,1,0,0,0,0,0,0,0,0,0,0,5
0,0,0,0,1,0,6,1,1,1,1,0,0,0,0,0,2,0,0,14
0,0,0,0,1,0,6,1,1,0,0,6,0,0,2,0,0,2,0,0
1,0,7,0,0,0,0,1,0,0,0,6,1,0,0,0,0,0,0,0
0,0,0,0,0,0,0,1,1,0,1,0,1,0,2,0,0,0,0,3
1,0,6,0,0,0,0,0,1,0,0,0,0,0,1,0,0,2,0,0
0,0,0,0,0,0,0,0,1,0,0,0,0,0,1,0,0,0,0,6
0,0,0,0,0,0,0,0,1,0,0,0,0,0,1,0,0,0,0,6
0,0,0,0,0,0,0,0,1,0,0,0,0,0,0,0,1,1,0,0
0,0,0,0,0,0,0,0,0,0,0,0,0,0,0,0,0,0,0,0
0,0,0,0,0,0,0,0,1,0,0,0,0,0,1,0,0,0,0,7
0,0,0,0,1,0,2,0,0,0,0,0,0,0,0,0,0,0,0,0
0,0,0,0,1,0,4,0,0,0,0,0,0,0,0,0,0,0,0,0
0,0,0,0,1,0,6,0,0,0,0,0,0,0,0,0,0,0,0,0
0,0,0,0,1,0,7,0,0,0,0,0,0,0,0,0,0,0,0,0
0,0,0,0,0,0,0,0,0,0,0,0,0,0,0,0,0,0,0,0
0,0,0,0,0,0,0,1,0,0,1,0,0,6,0,0,0,0,0,0
0,0,0,0,0,0,0,1,0,1,0,7,2,0,0,0,0,0,0,0
1,0,5,0,0,0,0,0,0,0,0,0,0,0,0,0,0,0,0,0

