0,0,0,0,0,0,0,0,1,0,0,0,0,0,0,1,2,0,1,2
0,0,0,0,0,0,0,0,1,0,0,0,0,0,0,1,3,0,1,0
0,0,0,0,0,0,0,0,1,0,0,0,0,0,0,1,2,0,1,1
0,0,0,0,0,0,0,0,1,0,0,0,0,0,0,1,2,0,1,0
0,0,0,0,1,0,11,0,1,0,0,0,0,0,1,1,0,0,0,8
0,0,0,0,1,0,12,0,1,0,0,0,0,0,0,0,11,0,0,10
0,0,0,0,1,0,16,1,1,0,1,0,0,12,0,1,0,0,1,0
1,0,17,0,0,0,0,1,1,0,1,0,1,0,0,1,3,0,1,2
1,0,13,0,1,0,15,0,1,0,0,0,0,0,0,1,1,0,1,0
0,0,0,0,1,0,14,0,1,0,0,0,0,0,0,0,13,1,1,0
0,0,0,0,1,0,11,1,1,0,0,15,1,0,0,0,14,0,0,11
1,0,11,0,1,0,14,1,1,1,0,15,0,11,1,1,0,0,0,8
1,0,13,0,1,0,12,1,1,1,0,16,0,12,0,0,11,0,0,13
1,0,11,0,1,0,14,0,1,0,0,0,0,0,0,0,14,0,0,10
0,0,0,0,1,0,11,0,1,0,0,0,0,0,0,0,11,0,0,11
0,0,0,0,0,0,0,1,1,1,1,0,0,12,0,0,13,0,0,13
0,0,0,0,0,0,0,1,1,0,1,0,1,0,2,1,0,2,1,0
0,0,0,0,0,0,0,1,1,0,2,0,0,11,0,0,17,1,1,0
1,1,2,0,0,0,0,0,1,0,0,0,0,0,1,1,0,0,0,4
0,0,0,0,0,0,0,1,0,1,0,14,1,0,0,0,0,0,0,0
1,1,0,0,1,0,11,0,0,0,0,0,0,0,0,0,0,0,0,0
0,0,0,0,0,0,0,1,0,1,1,0,0,11,0,0,0,0,0,0
1,1,1,0,1,1,3,0,0,0,0,0,0,0,0,0,0,0,0,0
0,0,0,0,0,0,0,0,1,0,0,0,0,0,0,0,2,0,0,4
0,0,0,0,0,0,0,0,1,0,0,0,0,0,0,0,0,0,0,4
0,0,0,0,0,0,0,0,1,0,0,0,0,0,0,0,2,0,0,8
0,0,0,0,0,0,0,0,1,0,0,0,0,0,0,0,3,0,0,2
0,0,0,0,1,0,11,1,1,1,1,0,0,0,0,0,0,0,0,5
1,0,11,0,1,0,12,1,1,0,0,11,0,0,0,0,2,0,0,9
1,0,12,0,0,0,0,1,1,0,1,0,0,12,0,0,11,0,0,11
0,0,0,0,0,0,0,1,1,0,1,0,1,0,2,0,0,0,0,3
1,0,11,0,1,0,13,0,1,0,0,0,0,0,0,0,2,0,0,5
0,0,0,0,0,0,0,0,1,0,0,0,0,0,1,0,0,0,0,11
0,0,0,0,0,0,0,0,1,0,0,0,0,0,0,0,1,1,0,0
0,0,0,0,0,0,0,0,1,0,0,0,0,0,1,0,0,0,0,12
0,0,0,0,1,0,12,0,1,0,0,0,0,0,0,0,13,0,0,11
0,0,0,0,1,0,11,0,1,0,0,0,0,0,0,0,12,0,0,11
0,0,0,0,1,0,12,0,0,0,0,0,0,0,0,0,0,0,0,0
0,0,0,0,0,0,0,1,0,0,1,0,0,11,0,0,0,0,0,0
0,0,0,0,1,0,4,1,0,1,0,12,2,0,0,0,0,0,0,0
1,0,5,0,1,0,2,0,0,0,0,0,0,0,0,0,0,0,0,0
